"week","knr","2019","2020","difference_people","percrank","0","color"
"01",1,132840,81535,-51305,7,0,"lightblue"
"01",2,70012,56826,-13186,6,0,"lightblue"
"01",3,2914,6984,4070,7,0,"lightblue"
"01",4,39909,26108,-13801,2,0,"lightblue"
"01",5,172916,132092,-40824,2,0,"lightblue"
"01",6,74338,66344,-7994,3,0,"lightblue"
"01",8,2696,1958,-738,1,0,"lightblue"
"01",9,55182,31628,-23554,8,0,"lightblue"
"01",10,86140,45314,-40826,0,0,"lightblue"
"01",11,193055,101585,-91470,2,0,"lightblue"
"01",12,1205,1185,-20,2,0,"lightblue"
"02",1,173006,187295,14289,10,0,"lightblue"
"02",2,63637,121174,57537,9,0,"lightblue"
"02",3,1444,23381,21937,10,0,"lightblue"
"02",4,51787,86834,35047,7,0,"lightblue"
"02",5,167730,276779,109049,10,0,"lightblue"
"02",6,64633,119109,54476,10,0,"lightblue"
"02",8,4436,8987,4551,8,0,"lightblue"
"02",9,69908,72940,3032,10,0,"lightblue"
"02",10,124928,94187,-30741,0,0,"lightblue"
"02",11,233158,216822,-16336,7,0,"lightblue"
"02",12,1238,4227,2989,6,0,"lightblue"
"03",1,205567,128388,-77179,4,0,"lightblue"
"03",2,93115,124581,31466,9,0,"lightblue"
"03",3,6324,23950,17626,10,0,"lightblue"
"03",4,70246,90675,20429,6,0,"lightblue"
"03",5,228619,281637,53018,9,0,"lightblue"
"03",6,108018,129404,21386,8,0,"lightblue"
"03",8,6558,9487,2929,6,0,"lightblue"
"03",9,75656,74908,-748,10,0,"lightblue"
"03",10,82572,95333,12761,9,0,"lightblue"
"03",11,246153,217886,-28267,6,0,"lightblue"
"03",12,5866,4216,-1650,1,0,"lightblue"
"04",1,188953,108445,-80508,3,0,"lightblue"
"04",2,85768,111028,25260,8,0,"lightblue"
"04",3,6472,21739,15267,9,0,"lightblue"
"04",4,72225,80530,8305,4,0,"lightblue"
"04",5,219847,260298,40451,8,0,"lightblue"
"04",6,100982,115038,14056,7,0,"lightblue"
"04",8,6512,8186,1674,4,0,"lightblue"
"04",9,76151,72898,-3253,9,0,"lightblue"
"04",10,84043,92777,8734,8,0,"lightblue"
"04",11,256795,218316,-38479,6,0,"lightblue"
"04",12,4934,3678,-1256,1,0,"lightblue"
"05",1,195620,102378,-93242,3,0,"lightblue"
"05",2,79041,99665,20624,8,0,"lightblue"
"05",3,5651,19392,13741,8,0,"lightblue"
"05",4,61972,73199,11227,4,0,"lightblue"
"05",5,204158,239061,34903,8,0,"lightblue"
"05",6,90845,98762,7917,6,0,"lightblue"
"05",8,5524,6777,1253,3,0,"lightblue"
"05",9,73723,69896,-3827,9,0,"lightblue"
"05",10,81051,82883,1832,7,0,"lightblue"
"05",11,251028,221549,-29479,6,0,"lightblue"
"05",12,4070,3273,-797,1,0,"lightblue"
"06",1,192016,106272,-85744,3,0,"lightblue"
"06",2,82774,113066,30292,8,0,"lightblue"
"06",3,5578,19903,14325,9,0,"lightblue"
"06",4,59866,75927,16061,5,0,"lightblue"
"06",5,201186,253307,52121,9,0,"lightblue"
"06",6,96120,122920,26800,9,0,"lightblue"
"06",8,5486,7112,1626,4,0,"lightblue"
"06",9,72731,63872,-8859,9,0,"lightblue"
"06",10,83102,85114,2012,7,0,"lightblue"
"06",11,246158,228862,-17296,7,0,"lightblue"
"06",12,3901,3543,-358,1,0,"lightblue"
"07",1,198267,77242,-121025,1,0,"lightblue"
"07",2,108437,79869,-28568,5,0,"lightblue"
"07",3,6218,13546,7328,7,0,"lightblue"
"07",4,69951,52558,-17393,2,0,"lightblue"
"07",5,257234,198306,-58928,2,0,"lightblue"
"07",6,152251,89279,-62972,0,0,"lightblue"
"07",8,5805,4219,-1586,1,0,"lightblue"
"07",9,75606,45243,-30363,7,0,"lightblue"
"07",10,75419,57200,-18219,1,0,"lightblue"
"07",11,254746,171353,-83393,3,0,"lightblue"
"07",12,5277,2211,-3066,1,0,"lightblue"
"08",1,228890,104786,-124104,1,0,"lightblue"
"08",2,117378,115870,-1508,7,0,"lightblue"
"08",3,7553,21262,13709,8,0,"lightblue"
"08",4,83000,80292,-2708,3,0,"lightblue"
"08",5,279894,265540,-14354,3,0,"lightblue"
"08",6,169200,128473,-40727,1,0,"lightblue"
"08",8,7471,7136,-335,2,0,"lightblue"
"08",9,79300,53687,-25613,8,0,"lightblue"
"08",10,86109,75512,-10597,2,0,"lightblue"
"08",11,288172,222394,-65778,4,0,"lightblue"
"08",12,6982,3767,-3215,0,0,"lightblue"
"09",1,233233,109034,-124199,1,0,"lightblue"
"09",2,119287,128469,9182,7,0,"lightblue"
"09",3,8644,22851,14207,9,0,"lightblue"
"09",4,93911,81654,-12257,2,0,"lightblue"
"09",5,286220,259427,-26793,3,0,"lightblue"
"09",6,164497,130661,-33836,1,0,"lightblue"
"09",8,9178,8497,-681,1,0,"lightblue"
"09",9,82812,55485,-27327,8,0,"lightblue"
"09",10,102124,89661,-12463,2,0,"lightblue"
"09",11,292725,220843,-71882,4,0,"lightblue"
"09",12,8054,3895,-4159,0,0,"lightblue"
"10",1,220472,103665,-116807,2,0,"lightblue"
"10",2,87753,118493,30740,8,0,"lightblue"
"10",3,7502,22397,14895,9,0,"lightblue"
"10",4,80345,80763,418,3,0,"lightblue"
"10",5,241546,253086,11540,6,0,"lightblue"
"10",6,113272,120588,7316,5,0,"lightblue"
"10",8,7823,8436,613,3,0,"lightblue"
"10",9,76057,53366,-22691,8,0,"lightblue"
"10",10,86048,86916,868,7,0,"lightblue"
"10",11,249623,203202,-46421,5,0,"lightblue"
"10",12,2628,3796,1168,4,0,"lightblue"
"11",1,199137,99970,-99167,2,0,"lightblue"
"11",2,99718,132832,33114,9,0,"lightblue"
"11",3,16119,27864,11745,8,0,"lightblue"
"11",4,74558,89054,14496,5,0,"lightblue"
"11",5,228593,273515,44922,9,0,"lightblue"
"11",6,97056,139399,42343,9,0,"lightblue"
"11",8,6915,10212,3297,6,0,"lightblue"
"11",9,72662,50783,-21879,9,0,"lightblue"
"11",10,84079,95499,11420,9,0,"lightblue"
"11",11,216835,191530,-25305,7,0,"lightblue"
"11",12,1156,5146,3990,6,0,"lightblue"
"12",1,239816,74089,-165727,0,0,"lightblue"
"12",2,154632,119181,-35451,4,0,"lightblue"
"12",3,29257,25037,-4220,4,0,"lightblue"
"12",4,105512,69382,-36130,1,0,"lightblue"
"12",5,320566,191035,-129531,0,0,"lightblue"
"12",6,162706,110332,-52374,1,0,"lightblue"
"12",8,10189,9569,-620,1,0,"lightblue"
"12",9,85827,30852,-54975,3,0,"lightblue"
"12",10,99339,92673,-6666,2,0,"lightblue"
"12",11,248450,148187,-100263,2,0,"lightblue"
"12",12,4135,6358,2223,5,0,"lightblue"
"13",1,248599,56311,-192288,0,0,"lightblue"
"13",2,152355,80234,-72121,1,0,"lightblue"
"13",3,33207,18515,-14692,0,0,"lightblue"
"13",4,116387,52345,-64042,0,0,"lightblue"
"13",5,327552,107954,-219598,0,0,"lightblue"
"13",6,162774,32455,-130319,0,0,"lightblue"
"13",8,11613,7399,-4214,0,0,"lightblue"
"13",9,88253,23526,-64727,0,0,"lightblue"
"13",10,107990,80568,-27422,1,0,"lightblue"
"13",11,250878,107145,-143733,0,0,"lightblue"
"13",12,4391,4547,156,2,0,"lightblue"
"14",1,201816,65132,-136684,1,0,"lightblue"
"14",2,135351,98155,-37196,4,0,"lightblue"
"14",3,27566,21778,-5788,3,0,"lightblue"
"14",4,100249,61812,-38437,0,0,"lightblue"
"14",5,224588,128534,-96054,1,0,"lightblue"
"14",6,54491,36543,-17948,2,0,"lightblue"
"14",8,9896,8252,-1644,0,0,"lightblue"
"14",9,87806,26603,-61203,1,0,"lightblue"
"14",10,18946,91347,72401,9,0,"lightblue"
"14",11,227676,126047,-101629,1,0,"lightblue"
"14",12,3706,5944,2238,5,0,"lightblue"
"15",1,208138,90725,-117413,2,0,"lightblue"
"15",2,113219,122669,9450,7,0,"lightblue"
"15",3,25480,28055,2575,6,0,"lightblue"
"15",4,99747,76295,-23452,1,0,"lightblue"
"15",5,221000,155980,-65020,1,0,"lightblue"
"15",6,52547,47937,-4610,3,0,"lightblue"
"15",8,9085,10514,1429,4,0,"lightblue"
"15",9,79748,28883,-50865,5,0,"lightblue"
"15",10,18568,96586,78018,10,0,"lightblue"
"15",11,212902,150605,-62297,4,0,"lightblue"
"15",12,3316,8371,5055,7,0,"lightblue"
"16",1,206111,101551,-104560,2,0,"lightblue"
"16",2,180258,131126,-49132,2,0,"lightblue"
"16",3,28697,29181,484,5,0,"lightblue"
"16",4,101943,81200,-20743,1,0,"lightblue"
"16",5,235342,165922,-69420,1,0,"lightblue"
"16",6,67400,50672,-16728,2,0,"lightblue"
"16",8,10759,10608,-151,2,0,"lightblue"
"16",9,80290,27881,-52409,4,0,"lightblue"
"16",10,22925,99976,77051,10,0,"lightblue"
"16",11,231248,143517,-87731,2,0,"lightblue"
"16",12,4239,8780,4541,7,0,"lightblue"
"17",1,168439,97467,-70972,4,0,"lightblue"
"17",2,137496,135279,-2217,6,0,"lightblue"
"17",3,23366,31852,8486,8,0,"lightblue"
"17",4,86021,89737,3716,3,0,"lightblue"
"17",5,204908,192109,-12799,4,0,"lightblue"
"17",6,55634,81258,25624,8,0,"lightblue"
"17",8,8310,12117,3807,7,0,"lightblue"
"17",9,73108,29835,-43273,5,0,"lightblue"
"17",10,20285,60274,39989,9,0,"lightblue"
"17",11,189403,142970,-46433,5,0,"lightblue"
"17",12,3208,8893,5685,8,0,"lightblue"
"18",1,186764,74025,-112739,2,0,"lightblue"
"18",2,111884,93496,-18388,6,0,"lightblue"
"18",3,23480,22655,-825,5,0,"lightblue"
"18",4,87116,63345,-23771,1,0,"lightblue"
"18",5,217972,114562,-103410,1,0,"lightblue"
"18",6,52410,70539,18129,8,0,"lightblue"
"18",8,7741,7919,178,2,0,"lightblue"
"18",9,72858,30291,-42567,6,0,"lightblue"
"18",10,19281,16896,-2385,4,0,"lightblue"
"18",11,192388,113500,-78888,3,0,"lightblue"
"18",12,3206,5239,2033,5,0,"lightblue"
"19",1,213318,92255,-121063,1,0,"lightblue"
"19",2,127187,148581,21394,8,0,"lightblue"
"19",3,24372,33316,8944,8,0,"lightblue"
"19",4,94778,96675,1897,3,0,"lightblue"
"19",5,221212,159891,-61321,1,0,"lightblue"
"19",6,53700,96650,42950,10,0,"lightblue"
"19",8,9605,13165,3560,7,0,"lightblue"
"19",9,81572,32604,-48968,5,0,"lightblue"
"19",10,19001,21678,2677,8,0,"lightblue"
"19",11,222483,148088,-74395,3,0,"lightblue"
"19",12,3688,8438,4750,7,0,"lightblue"
"20",1,222455,110039,-112416,2,0,"lightblue"
"20",2,150967,136932,-14035,6,0,"lightblue"
"20",3,30147,31640,1493,5,0,"lightblue"
"20",4,121660,98599,-23061,1,0,"lightblue"
"20",5,252392,214537,-37855,3,0,"lightblue"
"20",6,72775,86520,13745,7,0,"lightblue"
"20",8,12532,12439,-93,2,0,"lightblue"
"20",9,84798,33808,-50990,4,0,"lightblue"
"20",10,21973,19632,-2341,5,0,"lightblue"
"20",11,232283,161834,-70449,4,0,"lightblue"
"20",12,5088,7245,2157,5,0,"lightblue"
"21",1,207859,121361,-86498,3,0,"lightblue"
"21",2,174191,189019,14828,8,0,"lightblue"
"21",3,27539,37631,10092,8,0,"lightblue"
"21",4,110459,114760,4301,4,0,"lightblue"
"21",5,235437,250699,15262,6,0,"lightblue"
"21",6,54268,96900,42632,9,0,"lightblue"
"21",8,11057,15368,4311,8,0,"lightblue"
"21",9,84050,34315,-49735,5,0,"lightblue"
"21",10,21625,19056,-2569,4,0,"lightblue"
"21",11,229411,190929,-38482,6,0,"lightblue"
"21",12,4374,9111,4737,7,0,"lightblue"
"22",1,197415,145187,-52228,6,0,"lightblue"
"22",2,238272,198922,-39350,3,0,"lightblue"
"22",3,28772,44097,15325,9,0,"lightblue"
"22",4,99397,137791,38394,7,0,"lightblue"
"22",5,264294,288436,24142,7,0,"lightblue"
"22",6,84730,113768,29038,9,0,"lightblue"
"22",8,11184,18113,6929,10,0,"lightblue"
"22",9,79923,42873,-37050,7,0,"lightblue"
"22",10,23896,14045,-9851,2,0,"lightblue"
"22",11,217160,203380,-13780,8,0,"lightblue"
"22",12,4787,9697,4910,7,0,"lightblue"
"23",1,193138,114815,-78323,3,0,"lightblue"
"23",2,253385,161776,-91609,1,0,"lightblue"
"23",3,35029,32976,-2053,5,0,"lightblue"
"23",4,89952,106837,16885,5,0,"lightblue"
"23",5,303621,245592,-58029,2,0,"lightblue"
"23",6,82762,87281,4519,5,0,"lightblue"
"23",8,14890,13320,-1570,1,0,"lightblue"
"23",9,81717,36972,-44745,5,0,"lightblue"
"23",10,21040,12025,-9015,2,0,"lightblue"
"23",11,219089,158657,-60432,5,0,"lightblue"
"23",12,6193,7046,853,3,0,"lightblue"
"24",1,195510,138394,-57116,5,0,"lightblue"
"24",2,197484,165922,-31562,4,0,"lightblue"
"24",3,29419,36508,7089,7,0,"lightblue"
"24",4,66215,122170,55955,8,0,"lightblue"
"24",5,266218,286821,20603,7,0,"lightblue"
"24",6,70900,96486,25586,8,0,"lightblue"
"24",8,11791,14324,2533,5,0,"lightblue"
"24",9,80633,38142,-42491,6,0,"lightblue"
"24",10,20476,19111,-1365,5,0,"lightblue"
"24",11,219054,174804,-44250,5,0,"lightblue"
"24",12,5021,7190,2169,5,0,"lightblue"
"25",1,196417,133090,-63327,5,0,"lightblue"
"25",2,281148,173696,-107452,1,0,"lightblue"
"25",3,34238,37166,2928,7,0,"lightblue"
"25",4,86955,125924,38969,7,0,"lightblue"
"25",5,259312,267811,8499,6,0,"lightblue"
"25",6,103450,92583,-10867,3,0,"lightblue"
"25",8,15101,15044,-57,2,0,"lightblue"
"25",9,87357,37919,-49438,5,0,"lightblue"
"25",10,19309,20130,821,6,0,"lightblue"
"25",11,255418,170844,-84574,3,0,"lightblue"
"25",12,6347,8030,1683,4,0,"lightblue"
"26",1,189453,146024,-43429,7,0,"lightblue"
"26",2,481645,283914,-197731,0,0,"lightblue"
"26",3,37116,30326,-6790,2,0,"lightblue"
"26",4,98531,156229,57698,9,0,"lightblue"
"26",5,327256,306515,-20741,3,0,"lightblue"
"26",6,123900,81968,-41932,1,0,"lightblue"
"26",8,16677,18488,1811,5,0,"lightblue"
"26",9,74087,40948,-33139,7,0,"lightblue"
"26",10,22822,22881,59,6,0,"lightblue"
"26",11,271536,198130,-73406,4,0,"lightblue"
"26",12,6124,9447,3323,6,0,"lightblue"
"27",1,165241,142920,-22321,9,0,"lightblue"
"27",2,313780,280573,-33207,4,0,"lightblue"
"27",3,26242,28824,2582,6,0,"lightblue"
"27",4,94714,147340,52626,8,0,"lightblue"
"27",5,296967,298399,1432,5,0,"lightblue"
"27",6,78217,80955,2738,4,0,"lightblue"
"27",8,16061,18119,2058,5,0,"lightblue"
"27",9,83998,42048,-41950,6,0,"lightblue"
"27",10,21206,20403,-803,6,0,"lightblue"
"27",11,245354,191671,-53683,5,0,"lightblue"
"27",12,6017,9086,3069,6,0,"lightblue"
"28",1,152438,156571,4133,10,0,"lightblue"
"28",2,218030,285987,67957,9,0,"lightblue"
"28",3,24638,30608,5970,7,0,"lightblue"
"28",4,87977,159923,71946,10,0,"lightblue"
"28",5,290386,312895,22509,7,0,"lightblue"
"28",6,66979,72639,5660,5,0,"lightblue"
"28",8,15623,20394,4771,9,0,"lightblue"
"28",9,82625,45011,-37614,6,0,"lightblue"
"28",10,22908,21973,-935,6,0,"lightblue"
"28",11,255551,200145,-55406,5,0,"lightblue"
"28",12,5317,9812,4495,6,0,"lightblue"
"29",1,172193,140367,-31826,8,0,"lightblue"
"29",2,349316,238659,-110657,1,0,"lightblue"
"29",3,23848,25594,1746,6,0,"lightblue"
"29",4,85288,131952,46664,8,0,"lightblue"
"29",5,273593,269068,-4525,5,0,"lightblue"
"29",6,66524,74816,8292,6,0,"lightblue"
"29",8,13525,15228,1703,5,0,"lightblue"
"29",9,73550,40937,-32613,7,0,"lightblue"
"29",10,20154,19058,-1096,5,0,"lightblue"
"29",11,203466,171591,-31875,6,0,"lightblue"
"30",1,143192,129972,-13220,9,0,"lightblue"
"30",2,289413,249180,-40233,3,0,"lightblue"
"30",3,23532,25652,2120,6,0,"lightblue"
"30",4,75225,134850,59625,9,0,"lightblue"
"30",5,259257,262661,3404,5,0,"lightblue"
"30",6,60578,84148,23570,8,0,"lightblue"
"30",8,11166,15409,4243,8,0,"lightblue"
"30",9,53545,41033,-12512,9,0,"lightblue"
"30",10,15678,18531,2853,8,0,"lightblue"
"30",11,106351,164097,57746,10,0,"lightblue"
"31",1,154768,118022,-36746,8,0,"lightblue"
"31",2,145859,296540,150681,10,0,"lightblue"
"31",3,27294,23816,-3478,5,0,"lightblue"
"31",4,63465,129154,65689,9,0,"lightblue"
"31",5,232434,248337,15903,6,0,"lightblue"
"31",6,67109,79986,12877,7,0,"lightblue"
"31",8,9766,14453,4687,8,0,"lightblue"
"31",9,69647,40593,-29054,8,0,"lightblue"
"31",10,20393,17993,-2400,4,0,"lightblue"
"31",11,124375,150553,26178,9,0,"lightblue"
"32",1,177560,140813,-36747,8,0,"lightblue"
"32",2,217671,250440,32769,9,0,"lightblue"
"32",3,27881,22796,-5085,3,0,"lightblue"
"32",4,66795,121140,54345,8,0,"lightblue"
"32",5,237992,254700,16708,7,0,"lightblue"
"32",6,67712,77668,9956,6,0,"lightblue"
"32",8,10205,13360,3155,6,0,"lightblue"
"32",9,75542,42525,-33017,7,0,"lightblue"
"32",10,17441,18029,588,6,0,"lightblue"
"32",11,127756,171602,43846,9,0,"lightblue"
"33",1,202132,141670,-60462,5,0,"lightblue"
"33",2,213649,300162,86513,10,0,"lightblue"
"33",3,35149,29098,-6051,2,0,"lightblue"
"33",4,78378,149664,71286,10,0,"lightblue"
"33",5,268082,291465,23383,7,0,"lightblue"
"33",6,79071,92716,13645,7,0,"lightblue"
"33",8,12962,18636,5674,9,0,"lightblue"
"33",9,83273,42108,-41165,6,0,"lightblue"
"33",10,21138,18365,-2773,3,0,"lightblue"
"33",11,159684,171865,12181,8,0,"lightblue"
"34",1,200003,148813,-51190,7,0,"lightblue"
"34",2,251314,212112,-39202,3,0,"lightblue"
"34",3,34133,28232,-5901,2,0,"lightblue"
"34",4,77079,147308,70229,9,0,"lightblue"
"34",5,273517,297720,24203,8,0,"lightblue"
"34",6,77261,86927,9666,6,0,"lightblue"
"34",8,13130,19189,6059,10,0,"lightblue"
"34",9,82657,22127,-60530,1,0,"lightblue"
"34",10,19424,18232,-1192,5,0,"lightblue"
"34",11,148437,172753,24316,9,0,"lightblue"
"35",1,199742,148293,-51449,6,0,"lightblue"
"35",2,322874,133277,-189597,0,0,"lightblue"
"35",3,39844,25742,-14102,0,0,"lightblue"
"35",4,95822,128688,32866,7,0,"lightblue"
"35",5,315975,270242,-45733,2,0,"lightblue"
"35",6,94293,68517,-25776,2,0,"lightblue"
"35",8,16830,17577,747,3,0,"lightblue"
"35",9,88324,9332,-78992,0,0,"lightblue"
"35",10,19661,16500,-3161,3,0,"lightblue"
"35",11,161362,147537,-13825,7,0,"lightblue"
"36",1,193493,175232,-18261,9,0,"lightblue"
"36",2,157740,161513,3773,7,0,"lightblue"
"36",3,32233,28412,-3821,4,0,"lightblue"
"36",4,76341,142220,65879,9,0,"lightblue"
"36",5,259360,312701,53341,10,0,"lightblue"
"36",6,73354,69061,-4293,4,0,"lightblue"
"36",8,12796,18196,5400,9,0,"lightblue"
"36",9,77714,24037,-53677,4,0,"lightblue"
"36",10,17449,19098,1649,7,0,"lightblue"
"36",11,136795,175963,39168,9,0,"lightblue"
"37",1,203545,206873,3328,9,0,"lightblue"
"37",2,214844,194489,-20355,5,0,"lightblue"
"37",3,36560,29544,-7016,2,0,"lightblue"
"37",4,102409,153447,51038,8,0,"lightblue"
"37",5,289117,333444,44327,9,0,"lightblue"
"37",6,86057,74648,-11409,3,0,"lightblue"
"37",8,14301,20018,5717,9,0,"lightblue"
"37",9,83227,28419,-54808,3,0,"lightblue"
"37",10,21886,20628,-1258,5,0,"lightblue"
"37",11,161836,228317,66481,10,0,"lightblue"
"38",1,238542,195434,-43108,8,0,"lightblue"
"38",2,188671,149537,-39134,3,0,"lightblue"
"38",3,39712,29940,-9772,1,0,"lightblue"
"38",4,113328,155590,42262,8,0,"lightblue"
"38",5,288385,327224,38839,8,0,"lightblue"
"38",6,91179,87023,-4156,4,0,"lightblue"
"38",8,15803,20271,4468,8,0,"lightblue"
"38",9,82759,27399,-55360,3,0,"lightblue"
"38",10,21980,18879,-3101,3,0,"lightblue"
"38",11,190784,204500,13716,8,0,"lightblue"
"39",1,207791,156306,-51485,6,0,"lightblue"
"39",2,147004,80183,-66821,1,0,"lightblue"
"39",3,28923,24192,-4731,4,0,"lightblue"
"39",4,96149,119550,23401,6,0,"lightblue"
"39",5,266267,261817,-4450,5,0,"lightblue"
"39",6,74195,70695,-3500,4,0,"lightblue"
"39",8,11572,15416,3844,7,0,"lightblue"
"39",9,80812,20425,-60387,1,0,"lightblue"
"39",10,33684,15933,-17751,1,0,"lightblue"
"39",11,140286,146348,6062,8,0,"lightblue"
"40",1,199479,172603,-26876,8,0,"lightblue"
"40",2,129181,88079,-41102,2,0,"lightblue"
"40",3,28934,23466,-5468,3,0,"lightblue"
"40",4,85938,121482,35544,7,0,"lightblue"
"40",5,251673,288513,36840,8,0,"lightblue"
"40",6,83671,72054,-11617,2,0,"lightblue"
"40",8,11141,15512,4371,8,0,"lightblue"
"40",9,77068,23162,-53906,4,0,"lightblue"
"40",10,31776,17522,-14254,1,0,"lightblue"
"40",11,129456,167610,38154,9,0,"lightblue"
"41",1,198713,154690,-44023,7,0,"lightblue"
"41",2,131171,68596,-62575,2,0,"lightblue"
"41",3,24831,18750,-6081,2,0,"lightblue"
"41",4,78042,97139,19097,6,0,"lightblue"
"41",5,290629,265414,-25215,3,0,"lightblue"
"41",6,131589,97298,-34291,1,0,"lightblue"
"41",8,9124,11410,2286,5,0,"lightblue"
"41",9,74789,17304,-57485,2,0,"lightblue"
"41",10,72089,50779,-21310,1,0,"lightblue"
"41",11,130717,122563,-8154,8,0,"lightblue"
"41",12,1904,4841,2937,5,0,"lightblue"
"42",1,193024,156646,-36378,8,0,"lightblue"
"42",2,129438,83906,-45532,2,0,"lightblue"
"42",3,26771,18046,-8725,1,0,"lightblue"
"42",4,80825,94354,13529,5,0,"lightblue"
"42",5,281681,270191,-11490,4,0,"lightblue"
"42",6,127746,109258,-18488,2,0,"lightblue"
"42",8,9379,11380,2001,5,0,"lightblue"
"42",9,75106,17669,-57437,2,0,"lightblue"
"42",10,74442,71879,-2563,4,0,"lightblue"
"42",11,153150,141490,-11660,8,0,"lightblue"
"42",12,4578,4876,298,2,0,"lightblue"
"43",1,210578,162572,-48006,7,0,"lightblue"
"43",2,153057,103515,-49542,2,0,"lightblue"
"43",3,33419,21120,-12299,1,0,"lightblue"
"43",4,97989,104649,6660,4,0,"lightblue"
"43",5,351150,300802,-50348,2,0,"lightblue"
"43",6,148417,128393,-20024,2,0,"lightblue"
"43",8,13132,14164,1032,3,0,"lightblue"
"43",9,84009,22021,-61988,1,0,"lightblue"
"43",10,98024,93598,-4426,3,0,"lightblue"
"43",11,262087,156545,-105542,1,0,"lightblue"
"43",12,5957,6283,326,2,0,"lightblue"
"44",1,193201,135644,-57557,5,0,"lightblue"
"44",2,106294,79676,-26618,5,0,"lightblue"
"44",3,22815,17756,-5059,3,0,"lightblue"
"44",4,64788,80193,15405,5,0,"lightblue"
"44",5,258260,247783,-10477,4,0,"lightblue"
"44",6,93181,99668,6487,5,0,"lightblue"
"44",8,8556,10012,1456,4,0,"lightblue"
"44",9,77222,18351,-58871,2,0,"lightblue"
"44",10,81502,83468,1966,7,0,"lightblue"
"44",11,255538,137777,-117761,0,0,"lightblue"
"44",12,3738,4791,1053,3,0,"lightblue"
"45",1,205162,144222,-60940,5,0,"lightblue"
"45",2,114083,95643,-18440,5,0,"lightblue"
"45",3,25152,19568,-5584,3,0,"lightblue"
"45",4,67637,94746,27109,6,0,"lightblue"
"45",5,273271,272536,-735,5,0,"lightblue"
"45",6,104575,116945,12370,7,0,"lightblue"
"45",8,9460,12964,3504,7,0,"lightblue"
"45",9,76020,21948,-54072,3,0,"lightblue"
"45",10,89589,93509,3920,8,0,"lightblue"
"45",11,254023,147467,-106556,1,0,"lightblue"
"45",12,4031,5384,1353,4,0,"lightblue"
"46",1,209485,158135,-51350,6,0,"lightblue"
"46",2,115500,113569,-1931,6,0,"lightblue"
"46",3,25147,21422,-3725,4,0,"lightblue"
"46",4,94190,106289,12099,5,0,"lightblue"
"46",5,274723,314788,40065,8,0,"lightblue"
"46",6,103311,139565,36254,9,0,"lightblue"
"46",8,9310,14219,4909,9,0,"lightblue"
"46",9,77654,26685,-50969,4,0,"lightblue"
"46",10,88550,97996,9446,8,0,"lightblue"
"46",11,244290,161906,-82384,3,0,"lightblue"
"46",12,4329,6250,1921,4,0,"lightblue"
"47",1,215531,151314,-64217,5,0,"lightblue"
"47",2,120414,89094,-31320,4,0,"lightblue"
"47",3,25808,19568,-6240,2,0,"lightblue"
"47",4,94109,96310,2201,3,0,"lightblue"
"47",5,281263,286751,5488,6,0,"lightblue"
"47",6,109914,117359,7445,6,0,"lightblue"
"47",8,9692,12679,2987,6,0,"lightblue"
"47",9,77183,21359,-55824,3,0,"lightblue"
"47",10,94780,92773,-2007,5,0,"lightblue"
"47",11,249521,145583,-103938,1,0,"lightblue"
"47",12,4209,4848,639,3,0,"lightblue"
"48",1,203413,149655,-53758,6,0,"lightblue"
"48",2,104120,75633,-28487,5,0,"lightblue"
"48",3,21511,13524,-7987,1,0,"lightblue"
"48",4,86169,93113,6944,4,0,"lightblue"
"48",5,261108,262933,1825,5,0,"lightblue"
"48",6,91903,97390,5487,5,0,"lightblue"
"48",8,8501,12398,3897,7,0,"lightblue"
"48",9,75057,16152,-58905,2,0,"lightblue"
"48",10,87430,84744,-2686,4,0,"lightblue"
"48",11,237302,143748,-93554,2,0,"lightblue"
"48",12,3727,4866,1139,3,0,"lightblue"
"49",1,216661,141779,-74882,4,0,"lightblue"
"49",2,115018,62702,-52316,2,0,"lightblue"
"49",3,16112,15346,-766,5,0,"lightblue"
"49",4,88995,77107,-11888,2,0,"lightblue"
"49",5,276991,239023,-37968,2,0,"lightblue"
"49",6,93582,86931,-6651,3,0,"lightblue"
"49",8,9175,8870,-305,2,0,"lightblue"
"49",9,76480,14298,-62182,1,0,"lightblue"
"49",10,91610,85646,-5964,3,0,"lightblue"
"49",11,239858,134734,-105124,1,0,"lightblue"
"49",12,3835,3713,-122,2,0,"lightblue"
"50",1,209681,136813,-72868,4,0,"lightblue"
"50",2,101517,62225,-39292,3,0,"lightblue"
"50",3,19205,15192,-4013,4,0,"lightblue"
"50",4,77437,73204,-4233,2,0,"lightblue"
"50",5,239305,229995,-9310,4,0,"lightblue"
"50",6,87504,84584,-2920,4,0,"lightblue"
"50",8,7277,8390,1113,3,0,"lightblue"
"50",9,74953,15452,-59501,2,0,"lightblue"
"50",10,86762,79484,-7278,2,0,"lightblue"
"50",11,231636,132687,-98949,2,0,"lightblue"
"50",12,3139,3676,537,3,0,"lightblue"
"51",1,208571,138664,-69907,4,0,"lightblue"
"51",2,99653,72830,-26823,5,0,"lightblue"
"51",3,23452,15464,-7988,1,0,"lightblue"
"51",4,87999,81204,-6795,2,0,"lightblue"
"51",5,263020,250832,-12188,4,0,"lightblue"
"51",6,93063,99007,5944,5,0,"lightblue"
"51",8,8969,10374,1405,4,0,"lightblue"
"51",9,73401,16770,-56631,2,0,"lightblue"
"51",10,81709,85575,3866,8,0,"lightblue"
"51",11,235448,137810,-97638,2,0,"lightblue"
"51",12,3806,4031,225,2,0,"lightblue"
"52",1,99462,91949,-7513,9,0,"lightblue"
"52",2,51926,57590,5664,7,0,"lightblue"
"52",3,7359,9934,2575,6,0,"lightblue"
"52",4,28640,46221,17581,6,0,"lightblue"
"52",5,133661,176200,42539,9,0,"lightblue"
"52",6,57250,78216,20966,8,0,"lightblue"
"52",8,2151,5376,3225,6,0,"lightblue"
"52",9,39286,16607,-22679,8,0,"lightblue"
"52",10,45963,63815,17852,9,0,"lightblue"
"52",11,127289,107544,-19745,7,0,"lightblue"
"52",12,1134,2356,1222,4,0,"lightblue"
"29",12,NA,7344,NA,8,0,"lightblue"
"30",12,NA,7188,NA,8,0,"lightblue"
"31",12,NA,6417,NA,8,0,"lightblue"
"32",12,NA,6326,NA,8,0,"lightblue"
"33",12,NA,8046,NA,8,0,"lightblue"
"34",12,NA,8193,NA,9,0,"lightblue"
"35",12,NA,7688,NA,9,0,"lightblue"
"36",12,NA,8618,NA,9,0,"lightblue"
"37",12,NA,9405,NA,9,0,"lightblue"
"38",12,NA,9075,NA,9,0,"lightblue"
"39",12,NA,7188,NA,10,0,"lightblue"
"40",12,NA,6793,NA,10,0,"lightblue"
"53",1,NA,58362,NA,10,0,"lightblue"
"53",2,NA,26358,NA,10,0,"lightblue"
"53",3,NA,5000,NA,10,0,"lightblue"
"53",4,NA,23877,NA,10,0,"lightblue"
"53",5,NA,96282,NA,10,0,"lightblue"
"53",6,NA,43014,NA,10,0,"lightblue"
"53",8,NA,2332,NA,10,0,"lightblue"
"53",9,NA,7529,NA,10,0,"lightblue"
"53",10,NA,35114,NA,10,0,"lightblue"
"53",11,NA,71437,NA,10,0,"lightblue"
"53",12,NA,1234,NA,10,0,"lightblue"
